#########
#      1#
#0      #
#       #
# ##  2 >
# .#    #
# #######
# ,######
#########
;1
###
# #
# #
###
;2
###
# #
# #
###