#########
#.12222,#
#########
;1
######
<2.22>
######
;2
###
# #
# #
###