##########
##########
#   1    #
#        #
# 23 242 #
#### #####
#### #####
#### #####
#### #####
##########
;1
###
# #
# #
###
;2
###
# #
# #
###
;3
###
 ,#
###
;4
######
### ##
#   ##
# 1###
#   ##
### ##
### ##
### ##