####^####
#    ####
# #### ##
#       #
#       #
##  #####
#, 0#  ##
#.  1  ##
#########
;1
###
# #
# #
###
