#########
#.12222.#
#########
;1
######
<..22>
######
;2
###
# #
# #
###