#########
#   2  0#
#       #
# 1  ## #
<    #  #
## ###  #
## #,#  #
##   .###
####v####
;1
###
# #
# #
###
;2
###
# #
# #
###