###############
###############
#     1       #
# 2   , 2   2 #
# 2 2   2   2 #
# ... # . 2 . #
# .22 # .. 2. #
# ... # .2. . #
# .22 # . 2.. #
# .   # . 2 . #
# 2     2   2 #
# 2     2   2 #
#             #
###############
###############
;1
###
# #
###
;2
###
# #
###