#########
#     ###
# 1 0 ###
#       #
# 2   #.#
#   # ###
#     ###
#,    ###
####v####
;1
###
# #
###
;2
###
# #
###
